64
S...............................................................
.############################.#################################.
.#............................................................#.
.#............................................................#.
.#............................................................#.
.#............................................................#.
.#............................................................#.
.#............................................................#.
.#............................................................#.
.#................########..........#####.....................#.
.#..............##........##......###...##....................#.
.#.............##......######....##.......#...................#.
.#............#.......#.....##..#.........#...................#.
.#...........#.......##......#.##..........#..................#.
.#..........##.......##.......##...........#..................#.
.#.........#.......####.......#............#..................#.
.#........#.......#...........#............#..................#.
.#.......#.......#............#...............................#.
.#......#.......##........................#...................#.
.#......#.......#.........................#...................#.
.#.....#.......#.......................###....................#.
.#.....#.......#.......................#.##...................#.
.#.............#.......................#.#.#..................#.
.#....#.......#........................##...#.................#.
.#....#.......#........................##....#................#.
.#...#........#........................###.....#..............#.
.#...#........#........................#..###...#.............#.
.#...#........#.......................#......###..............#.
.#.............#.....................#............#...........#.
.#...#.........#...........G.........#.............#..........#.
.#...#.........#....................#...............#.........#.
.#...#.........#...................#.................#........#.
.#....#........#..................#...................#.......#.
.#.............#.................#....................#.......#.
.#....##........#...............#.....................#.......#.
.#..............#..............#......................#.......#.
.#.....#........##.............#......................#.......#.
.#......#........#............#......................##.......#.
.#.......#.......##.........##.......................#........#.
.#........#........#.......#.......................##.........#.
.#.........#.......##.....#....................#.##...........#.
.#...........#......##...#.............#.#.#.#................#.
.#............#.......#.#.#...#..#...#........................#.
.#.............#..#.#..##.....................................#.
.#...........#.###......###...................................#.
.#.........##.....##......#...................................#.
.#.........#.........##.......................................#.
.#.........#............###.#.#.#####.........................#.
.#..........##.......................##.......................#.
.#............#.#....................##.......############....#.
.#...............#.#................##.....####..........##...#.
.#..................#.#............##.....##..............##..#.
.#......................#.###.#.####.....##.#..............#..#.
.#......................................##..#..............#..#.
.#......................................#..########........#..#.
.#......................................#..####...#.##.....#..#.
.#.....................................##.#####..##.##.....#..#.
.#.....................................#.##......#...##.####..#.
.#.....................................#.##.....####....####..#.
.#.....................................###..#.#######...####..#.
.#.....................................###.####.....##.##.###.#.
.#.....................................##..######.######..###.#.
.#.....................................##......######.....###.#.
.#.....................................#..................#.#.#.